............
..OOO..OOO..
..O.O.OOOO..
........O...
....OOOOOO..
...OOOOOOOO.
.....OO.....
...OOOO...E.
.OOO..OOOOO.
.O..OOO.....
.OOOO.P.....
............