WWWWWWWWWWWW
SRGGBBBBBBRS
SRBWBRBBBBRS
WWWWWWSSBSSS
WWWWBBBBBBRB
WWWBBBBBBBBS
WWWWSBBSWWWW
SSSBBBBSSSBS
SBBBBSBBBBBS
SBSSBBBSSSBS
SBBBBSBBBBBS
RRRRRRRRRRRR