BBBBBBBBBWRW
RRRRRRRRBRWW
WRBWBRBWWWBB
WWWWWWWWWWWW
BBBBBBBBBBBB
RRRRRRRRRRRR
WWWWWWWWWWWW
RRRBBBBBBBBB
RRRRRRBBBBBB
RRRRRBBBBBWW
RRRRRBBBWWWW
WWWWWWWWWWWW