WWWWWWWWWWWW
SRBBBGGBBBRS
SRBWBRBBBBRS
WWWWWWSSBSSS
WWWWBBBBBBRB
WWWBBBBBBBBS
WWWWSBBSWWWW
SSSBBBBSSSBS
SBBBSSBBBBSS
SBSSBBBSSSBS
SBBBBSBBBBBS
RRRRRRRRRRRR